00000000000000000070008
500000004000004000001111
007000000000000000001h00
i00000000000000000001007
0000i0000i0000i000001110
00030000300000000000000i
0000077
111111111111000000000001
0000000000000000t
000000000000000000
011111111111111000000111
500070000700000000000000

00000000000000001 777
111111111111116666661111