0
0
000000000000008
7 1
1 7000001000000
00010000
000000070300700
0000000700007000000h0000
000000011111100000010000
0000000000000000000001

000000000000000000000000
000000000700h00070000000
000800100000100000010001
111166666666666666666666