0
0
0
0
0
0
0
0
0
0
000000000000000000000008
000000000000000000000021
000000000000000000000211
000000000000000000002111
111116611116666111111111