






87000000000000000000007
111111111111000011100111
000000000000001111107111
000000000000011111107111
0000000000711111111i7111
000000001111111111100111
000000011111111111107111
111111111111111111111111