
000080000700007
111111101111111001111001
666666666666666666661071
111111111111111111111001
0000000000000000000010i1
000000000000000000000001
000000000000000000000001
000000000000000000000111
0000000h000700070007
00007011001100110001

00770000300070030070003

111111111111111111111111
