

100111111111111111111111

111111111111111111111001

00000000003
000000
111111111111111111111001
0000000000000000000000i0

00000000t00000000t000000
0000000000000000000000i
0000000000000000000
111111111111111111111111