10000000000000000001
10000700000000000081
10000200000700000221
10000000002207050001
10000000500022000001
17001111111111111111
12000000001111111111
10000000000700700001
10200707222222222221
10020040000300300001
10000000022222220001
10000000001111100201
10000000000000000001
100000ss002020222221
10000022266666111111
12221111111111111111

