11111111111111111111
10000050000040000000
10000700000000000080
10000200000700000221
10000000002207050001
10000000500044000001
17002220000000000001
12000000000000000001
10000000000700700001
10200700000000000001
10020000000300300001
10002000022222220001
10000020007070000201
10000000000000000001
10000000002020222221
10000022266666111111
10000255111111111111
10002111110011111111
12221111111111111111
